11111111111111111111111111111
1P000010000000000010000000001
10101010111111111010111110101
1010101000100000101C100010101
10101011101010111010111010111
1C1010001C1010100010000010001
10101011101010101111111011101
1010100000101010100C000010001
10111011111010101011111110101
100010000C0010100000001000101
11101111111111111111111011101
1000100010000C000000100C10101
10111010101111111110101110101
100000100010000000000010000E1
11111111111111111111111111111
