11111111111111111111111111111
1P0C0000000010000000000000001
10111110111010111110111111101
10000010100010001010100010101
11111010111011101010101010101
10001010001000001000101010001
11101011101111111011101010111
10001000101000001010001010001
10101110101011101110111011101
10101000100000100000100010001
10111011111111111111101110111
10000010000000001000001000101
10111111101111101011111011101
100000000010000000100000000E1
11111111111111111111111111111
