11111111111111111111111111111
1P0000001000000C0000000C1C001
10101110111111111110111010101
10001000100000000C00101010101
11111011101111111111101010111
10001010100010000000001010001
10111010101010111011111010101
10100010001010100010000C10101
10101111111011101010111110101
10001000001000101010001010101
10111010101110101111101010101
10100010100000100000101000101
10111110111111101110101111101
100000001000000000100000000E1
11111111111111111111111111111
