11111111111111111111111
1c000000000000000c00001
111100000111000000c0001
1000000001e100000000011
100c00000001000000000p1
11111111111111111111111
