11111111111111111111111
1c0p0000000000000c00001
111100000ccc000000c0001
100000000cec00000000011
100c00000ccc00000000001
11111111111111111111111
