11111111111111111111111
11cp000000e000000000001
11111000000000000000001
10001000000000000000011
1000000000c000000000001
10000000000000000000001
10000000000000000000001
10000000000000000000001
10000000000000000000001
10001000000000c00000001
11111111111111111111111
