111111111111111111111111111111
1pc00000000000000c0000000000e1
101111111111111111111111111001
1010000000000000000000000c1001
101011111111111111111111111001
101000000000000000000000000001
1c1111111111111111111111111001
100000000000000000000000000001
111111111111111111111111111111