111111111111111111111111111111111111
1pc0000000000000000c00000000000000e1
100011111111111111111111111111000001
1000100000000000000000000000c1000001
100010111111111111111111111111000001
100010000000000000000000000000000001
100c11111111111111111111111111000001
1c0000000000000000000000000000000001
111111111111111111111111111111111111