111111111111111111111111111111111111111111111111111111111111111111111111111111111111111111111111111111111111111111111111111111111111111111111111
1p0000000000000000000000000000000000000000000000000000000000000000000000000000000000000000000000000000000000000000000000000000000000000000000001
100000000000000000000000000000000000000000000000000000000000000000000000000000000000000000000000000000000000000000000000000000000000000000000001
100000000000000000000000000000000000000000000000000000000000000000000000000000000000000000000000000000000000000000000000000000000000000000000001
10000000000000000000000000000000000000000000000000000000000000000000000000000000000000000000000c000000000000000000000000000000000000000000000001
1000000000000000000000000000000000000000000000c0000000000000000000000000000000000000000000000000000000000000000000000000000000000000000000000001
100000000000000000000000000000000000000000000000000000000000000000000000000000000000000000000000000000000000000000000000000000000000000000000001
100000001111111111111111111111111111111111111111111111111111111111111111111111111111111111111111111111111111111111111111111000010000000000000001
10000000100000000000000000000000000000000c000000000000000000000000000000000000000000000000000000000000000000000000000000000000010000000000000001
100000001000000000000000000000000000000000000000000000000000000000000000000000000000000000000000000000000000000000000000000000010000000000000001
100000001000000000000000000000000000000000000000000000000000000000000000000000000000000000000000000000000000000000000000000000010000000000000001
100000001000000000000000000000000000000000000000000000000000000000000000000000000000000000000000000000000000000000000000000000010000000000000001
100000001000000000000000000000000000000000000000000000000000000000000000000000000000000000000000000000000000000000000000000000010000000000000001
100000001000000000000000000000000000000000000000000000000000000000000000000000000000000000000000000000000000000000000000000000010000000000000001
100000001000000000000000000000000000000000000000000000000000000000000000000000000000000000000000000000000000000000000000000000010000000000000001
100000001000000000000000011111111111111111111111111111111111100000000000000000000000000000000000000000000000000000000000000000010000000000000001
100000001000000000000000010c0000000000000000c00000000000000c100000000000000000000000000000000000000000000000000000000000000000010000000000000001
100000001000000000000000010001111111111111111111111111100000100000000000000000000000000000000000000000000000000000000000000000010000000000000001
10000000100000000000000001000100000000000000000000000c100000100000000000000000000000000000000000000000000000000000000000000000010000000000000001
100000001000000000000000010001011111111111111111111111100000100000000000000000000000000000000000000000000000000000000000000000010000000000000001
10000000100000000000000001000100000000000000000000000000000010000000000000000c000000000000000000000000000000000000000000000000010000000000000001
1000000010000000000000000100c1111111111111111111111111100000100000000000000000000000000000000000000000000000000000000000000000010000000000000001
10000000100000000000000000c000000000000000000000000000000000100000000000000000000000000000000000000000000000000000000000000000010000000000000001
100000001000000000000000011111111111111111111111111111111111100000000000000000000000000000000000000000000000000000000000000000010000000000000001
100000001000000000000000000000000000000000000000000000000000000000000000000000000000000000000000000000000000000000000000000000010000000000000001
10000000100000000000000000000000000000000c000000000000000000000000000000000000000000000000000000000000000000000000000000000000010000000000000001
100000001000000000000000000000000000000000000000000000000000000000000000000000000000000000000000000000000000000000000000000000010000000000000001
100000001111111111111111111111111111111111111111111111111111111111111111111111111111111111111111111111111111111111111111111111110000000000000001
100000000000000000000000000000000000000000000000000000000000000000000000000000000000000000000000000000000000000000000000000000000000000000000001
100000000000000000000000000000000000000000000000000000000000000000000000000000000000000000000000000000000000000000000000000000000000000000000001
1000000000000000e0000000000000000000000000000000000000000000000000000000000000000000000000000000000000000000000000000000000000000000000000000001
111111111111111111111111111111111111111111111111111111111111111111111111111111111111111111111111111111111111111111111111111111111111111111111111