11111111111111111111111
11cp000000e000000000001
11111000001010000000001
10001000001010000000011
10000000011c11000000001
10000011111111111000001
10000000c11111c00000001
10000011111111111000001
10000000011c11000000001
10000000001010000000001
10000000001010000000001
10000000000000c00000001
10000000000000c00000001
11111111111111111111111