11111111111111111111111111111
1C0P1C0C1C0C0C00100C0C0C0C001
10111010101011101110101111111
1C101C1C0C101C1C0C101C1C0C001
10101011111010111010111011101
1C1C1C0C1C101C000C1C0C0C0C101
10101110101010111110111111101
1C1C0C0CiC1C1C0C100C1C0C1C001
10111111101011101011101010111
1C0C0C0C1C1C1C1C1C000C1C1C001
11111110111010101110111111101
1C0C0C1C0C0C1C1C0C101C0C0C101
10111111111110111011101110101
100000000000000000000010000E1
11111111111111111111111111111
