11111111111111111111111111111
111100000100000C1C10010010001
11101111001010110001001010101
110C0000101001110110010010011
10111010000010100100101011001
10001110101010001010000000011
10110001010010101000111010101
101C1101011001001011000101001
10001000001100101010011000011
1101011011i010101C10100011001
10000000001010100000001000101
11011C1C1000000P1011010010011
10100010010111010100100101001
100011001001000000010010000E1
11111111111111111111111111111
