11111111111111111111111111111
1C001C0C000C1000100C0C0C00101
10101010111110101011111010101
10101010000000100C10000010001
10101111111110111110111111101
101C0010000C10101000100000001
10111010111010101011111111111
100C10001010100C100000000C001
11101111101011101111111111101
101C1P1C00100C1C000C00000C101
10101010101110111011111111101
10100C101C00001000100i0000101
10111110111111111110111110101
100000000000000000001000000E1
11111111111111111111111111111
