11111111111111111111111111111
100100010010100i00101C000C011
11000100100000101110001011001
1C010101001101010C0C1C011C111
10100011011011000111011000001
11001C0001000C010C00010C11111
10010010100101100111101000001
10101C01010100010000000C10101
11001010000010101010110100111
1C01000C101C010010110C111C001
11001011010100010100010101011
1P010C010101010000010C0001001
11000100000100110110010110011
111010010100100011110011110E1
11111111111111111111111111111
