11111111111111111111111111111
11010010000110100C00001010101
10000101110000001110100000001
110101000001010110010P1010101
10110001101000100100010110101
1C000101010101010C01000001001
10111101000110001010011011101
110C0C01010C0C100C11000101001
111011010101i1001001010101101
11010101111010010010010C00101
10000000011011101101010101001
11011C1C100C00000000001101111
10100001010101101010100010001
100010100000100010010010001E1
11111111111111111111111111111
