11111111111111111111111111111
100C0001110001110100011P00101
10101010101100100001000011001
10010000100101001i11101000011
10101101101000011001001101001
11000001000110100110100100111
10101101101001001000001110001
1010100000010101001010010C111
10110110101000000100101010001
10000000100011010C10100001011
10101110010100011010010110001
10010000101001100010110001101
10101010000101101001000100101
110000010100100001001010010E1
11111111111111111111111111111
