11111111111111111111111111111
1ccccccccccc1ccccccccccccccc1
1c111111111c1c1c11111111111c1
1c1ccccc1ccc111c1ccccccccccc1
1ccc1c1ccc1c111c11c111111c1c1
1c1ccc11c11cccccccc1cccccc1c1
1c11c11ccc11111111c1c111111c1
111cc1cc1c1ccc1c1cc1ccccc11c1
1ccc1cc1cccc1ccc1c1c11c1cc1c1
1c111c11c1c1c11c1c1ccc1cc11c1
1c1cccccc1cccc1ccccc1c1c1ccc1
1c1c111111111cc11cc1cc1c1c111
1c1c1cccccccccc1cc11c1ec1ccc1
1c1c1c1111111111c1c1c111111c1
1pcc1cccccccccccccc1cccccccc1
11111111111111111111111111111