11111111111111111111111111111
1ccccccccccc1000c0000c0000c01
1c11111111101c101111111111101
101ccc001000111c1c000000000c1
100c1c10001011101101111110111
1c1ccc111110000000010000001c1
1c1101100c11111111010111111c1
111001c01010001c1c010000011c1
10001c0100001000101c11c10c1c1
10111011c101c1101c100010011c1
101c000cc1000c101100101010001
10101111111111001001001010111
1010100000000001001101ep10001
101010111111111101c1011111101
10001000000000000001000000001
11111111111111111111111111111
