11111111111111111111111
11cp0000000000000000001
11111110001010000000001
10001001111011000000011
100000000c1c1c010000001
10000011111c11111000001
100000000ccecc000000001
10000011111c11111000001
100000000c1c1c100000001
10000000101010100000001
10000000001010000000001
10000000000000c00000001
11111111111111111111111
