111111111111111111111111111111
1pccccccccccccccccccccccccccc1
1c1111111111111111111111111cc1
1c1cccccccccccccccccccccec1cc1
1c1c11111111111111111111111cc1
1c1cccccccccccccccccccccccccc1
1c1111111111111111111111111cc1
1cccccccccccccccccccccccccccc1
1cccccccccccccccccccccccccccc1
1cccccccccccccccccccccccccccc1
1cccccccccccccccccccccccccccc1
1cccccccccccccccccccccccccccc1
1cccccccccccccccccccccccccccc1
1cccccccccccccccccccccccccccc1
1cccccccccccccccccccccccccccc1
111111111111111111111111111111
