1111111111
100000e001
1000000001
1p00000001
1000000001
10c0000001
1111111111