111111111111111111111111111111111111111111111111111111111111
100C100010000000C01000000010000010C000001C0C0000000010000011
111010101011111C10101111101011101110111011111010111110101111
1010001010001010100C100010100010100E101C00001010000010100C11
1011111011101C1C11111011101010101011101111101011111010111011
10001000100000101000000000101C100010001C00101000100010100011
1011101111111110101111111110101111101C101010111110111C101111
10001010000000C0100000CC1CCC10C00C101C10100C100C1000CC100011
111010111011111111111110111011111C1C111011111010101111111011
1000101C001C00C010000010001010001010C0001000001010001C000011
10111010111110111010101110101C111010111110111110111110111C11
10000C10100C0010001010001C100010C01000001010C010000C10101011
101111101011111P11101111101111101111111C10101111111010101011
10000C001C000000001000C0CC00000C10C000000010000000000C10C011
111111111111111111111111111111111111111111111111111111111111
111111111111111111111111111111111111111111111111111111111111